111111111111111111111111
100000000000000000000001
100000000000000000000001
100000000000000000000001
100000000000000000000001
100000000000000000000001
100000000000000000000001
100000000073000000000001
100000000064000000000001
100000000064000000000001
100000000064000000000001
100000000054000000000001
122222222222222222222221
111111111111111111111111